[LADDER]
1584 204 16 216
[ENTITY]
# reference_id
[SECTION]
#section_id top left bottom right
2896 0 3120 1024
1872 1024 3120 1536
1888 1536 2128 2048
1120 2048 2112 2560
1904 2560 2144 3072
48 1536 1840 2048
544 2048 816 2560
336 2048 544 2560 
80 2048 336 2560
80 2560 592 3072
1632 768 1840 1536
1136 512 1840 768 
1120 768 1584 1280
1360 1296 1584 1536
1104 1296 1328 1536
[PORTAL]
#x y w h lx ly section_id_start section_id
960 3008 16 32 128 0 0 1
1072 3008 16 32 -128 0 1 0
1472 1984 16 32 128 0 1 2
1584 1984 16 32 -128 0 2 1
1984 1984 16 32 128 0 2 3
2096 1984 16 32 -128 0 3 2
2496 1984 16 32 128 0 3 4
2608 1984 16 32 -128 0 4 3
2096 1216 16 32 -128 0 3 5
1984 1216 16 32 128 0 5 3
1984 704 16 32 128 0 5 6
2096 704 16 32 -128 0 6 5
1984 192 16 32 128 0 5 8
2096 192 16 32 -128 0 8 5
2496 192 16 32 128 0 8 9
2608 192 16 32 -128 0 9 8
2496 448 16 32 128 0 7 9
2608 448 16 32 -128 0 9 7
1584 1728 16 32 -128 0 5 10
1472 1728 16 32 128 0 10 5
816 1728 16 32 -128 0 10 11
704 1728 16 32 128 0 11 10
704 1216 16 32 128 0 11 12
816 1216 16 32 -128 0 12 11
1216 1472 16 32 128 0 12 13
1328 1472 16 32 -128 0 13 12
1584 1216 16 32 -128 0 5 14
1472 1216 16 32 128 0 14 5
1472 3008 16 32 128 -2064 1 5
1584 960 16 32 -128 2064 5 1
#xywh00ssse
[ScenePortal]
3008 2000 16 16 0 0 4 29 1
1600 208 16 16 0 0 5 31 1
2432 784 16 16 0 0 6 32 1
2112 480 16 16 0 0 7 0 1
# must be used for camera locking
# section_id top left bottom right
