[ENTITY]
# reference_id
[SECTION]
#section_id top left bottom right
2880 0 3104 1080
1888 1024 3104 1520
1888 1536 2128 2032
1104 2048 2112 2544
1888 2560 2128 3056
48 1536 1840 2032
544 2048 800 2544
352 2048 528 2544 
80 2048 288 2544
80 2560 592 3088
1616 768 1824 1520
1120 512 1824 752 
1104 768 1568 1264
1344 1296 1568 1520
1088 1296 1312 1520
[PORTAL]
#x y w h lx ly section_id_start section_id
960 3008 16 32 128 0 0 1
1072 3008 16 32 -128 0 1 0
1472 1984 16 32 128 0 1 2
1584 1984 16 32 -128 0 2 1
1968 1984 16 32 128 0 2 3
2096 1984 16 32 -128 0 3 2
2496 1984 16 32 128 0 3 4
2608 1984 16 32 -128 0 4 3
2096 1216 16 32 -128 0 3 5
1984 1216 16 32 128 0 5 3
1984 704 16 32 128 0 5 6
2096 704 16 32 -128 0 6 5
1984 192 16 32 128 0 5 8
2096 192 16 32 -128 0 8 5
2496 192 16 32 128 0 8 9
2608 192 16 32 -128 0 9 8
2496 448 16 32 128 0 7 9
2608 448 16 32 -128 0 9 7
1584 1728 16 32 -128 0 5 10
1472 1728 16 32 128 0 10 5
816 1728 16 32 -128 0 10 11
704 1728 16 32 128 0 11 10
704 1216 16 32 128 0 11 12
816 1216 16 32 -128 0 12 11
1216 1472 16 32 128 0 12 13
1328 1472 16 32 -128 0 13 12
1584 1216 16 32 -128 0 5 14
1472 1216 16 32 128 0 14 5
1472 3008 16 32 128 -2064 1 5
1584 960 16 32 -128 2064 5 1
#xywh00ssse
3008 2000 16 16 0 0 4 29 1
1600 208 16 16 0 0 5 31 1
2432 784 16 16 0 0 6 32 1
2112 480 16 16 0 0 7 0 1
# must be used for camera locking
# section_id top left bottom right
